Time,Resource,Herbivores,Herbivores1,Herbivores2,Predators
1,53.0,50,18,32,14
2,55.0,43,14,29,22
3,59.0,40,12,28,25
4,62.0,34,11,23,39
5,64.0,30,11,19,58
6,67.0,28,10,18,77
7,70.0,25,10,15,101
8,73.0,23,9,14,125
9,77.0,21,7,14,152
10,80.0,20,7,13,179
11,84.0,19,6,13,209
12,88.0,19,6,13,234
13,92.0,15,4,11,268
14,97.0,14,3,11,298
15,102.0,10,3,7,336
16,106.0,9,2,7,373
17,111.0,7,1,6,409
18,117.0,3,1,2,455
19,123.0,2,1,1,498
